
NO ./textures/metal.xpm               
SO            ./textures/metal.xpm             
EA                 ./textures/metal.xpm                    
WE ./textures/metal.xpm



R   254 200



C 100, 0   , 100

F   0   ,   255,    90      

111111111111111111111111
100000000000000000000001
10000000000N000000000001
100000000000000000000001
100000111110000101010001      
100000000000000000000001
100000111110000101010001    
100000000000000000000001
100000111110000101010001                   
111111111111111111111111


